###############################
#  S  #       #       #       #
# # # # ##### # ##### # ### ###
# # #   #       #   # #   #   #
# # ### ######### # # ####### #
# # # # #         # #   #     #
### # # # ######### ### # ### #
#   #   # #     #   #   #   # #
# ### ### # # ### ### ##### # #
#   # # # # # # #   #   #   # #
### # # # ### # ### ### # ### #
#   #   # #   #     # # # #   #
# ### ### # ######### # # # ###
#   # #   #     #   #   # # # #
# # ### ### # ### # # ### # # #
# #     #   #     #  E    #   #
###############################
